lsp--erase-log-buffer 	lsp--erase-session-log-buffers
lsp--help-open-link 	lsp--semantic-tokens-verify
lsp-ansible-resync-inventory 	lsp-ansible-show-server-metadata
lsp-avy-lens 	lsp-breadcrumb-go-to-symbol
lsp-breadcrumb-narrow-to-symbol 	lsp-browser-mode
lsp-clangd-find-other-file 	lsp-cleanup-installation-buffers
lsp-clients-svlangserver-build-index 	lsp-clients-svlangserver-report-hierarchy
lsp-clojure--project-tree-ret-action 	lsp-clojure--test-tree-ret-action
lsp-clojure-add-import-to-namespace 	lsp-clojure-add-missing-libspec
lsp-clojure-backward-barf 	lsp-clojure-backward-slurp
lsp-clojure-clean-ns 	lsp-clojure-create-function
lsp-clojure-create-test 	lsp-clojure-cursor-info
lsp-clojure-cycle-coll 	lsp-clojure-cycle-privacy
lsp-clojure-expand-let 	lsp-clojure-extract-function
lsp-clojure-forward-barf 	lsp-clojure-forward-slurp
lsp-clojure-inline-symbol 	lsp-clojure-introduce-let
lsp-clojure-move-coll-entry-down 	lsp-clojure-move-coll-entry-up
lsp-clojure-move-form 	lsp-clojure-move-to-let
lsp-clojure-nrepl-connect 	lsp-clojure-resolve-macro-as
lsp-clojure-server-info 	lsp-clojure-server-info-raw
lsp-clojure-server-log 	lsp-clojure-show-project-tree
lsp-clojure-show-test-tree 	lsp-clojure-sort-map
lsp-clojure-thread-first 	lsp-clojure-thread-first-all
lsp-clojure-thread-last 	lsp-clojure-thread-last-all
lsp-clojure-unwind-all 	lsp-clojure-unwind-thread
lsp-cobol-start-ls 	lsp-command-map (S-l)
lsp-completion-mode 	lsp-copilot-check-status
lsp-copilot-login 	lsp-copilot-logout
lsp-csharp-open-project-file 	lsp-csharp-run-all-tests-in-buffer
lsp-csharp-run-last-tests 	lsp-csharp-run-test-at-point
lsp-csharp-run-test-in-buffer 	lsp-describe-session (s-l w d)
lsp-describe-thing-at-point (s-l h h) 	lsp-diagnose (lsp-doctor)
lsp-diagnostics-mode 	lsp-diagnostics-modeline-mode (lsp-modeline-diagnostics-mode)
lsp-dired-mode 	lsp-disconnect (s-l w D)
lsp-doctor 	lsp-document-highlight (s-l a h)
lsp-erlang-switch-server 	lsp-eslint-apply-all-fixes
lsp-eslint-create-default-configuration 	lsp-eslint-fix-all
lsp-evil-multiedit-highlights 	lsp-evil-multiedit-linked-ranges
lsp-evil-state-highlights 	lsp-evil-state-linked-ranges
lsp-execute-code-action (s-l a a) 	lsp-extend-selection
lsp-find-declaration (s-l g d) 	lsp-find-definition (s-l g g)
lsp-find-definition-mouse (C-<down-mouse-1>) 	lsp-find-implementation (s-l g i)
lsp-find-references (s-l g r) 	lsp-find-type-definition (s-l g t)
lsp-format-buffer (s-l = =) 	lsp-format-region (s-l = r)
lsp-goto-implementation (lsp-find-implementation) 	lsp-goto-type-definition (lsp-find-type-definition)
lsp-headerline-breadcrumb-mode (s-l T b) 	lsp-help-mode
lsp-ido-workspace-symbol 	lsp-iedit-highlights
lsp-iedit-linked-ranges 	lsp-inlay-hints-mode
lsp-inline-completion-company-integration-mode 	lsp-inline-completion-display
lsp-inline-completion-mode 	lsp-install-server
lsp-installation-buffer-mode 	lsp-javascript-remove-unused-imports
lsp-javascript-rename-file 	lsp-json-rpc-stderr
lsp-kotlin-implement-member 	lsp-kotlin-lens-mode
lsp-kubernetes-helm-download-or-refresh-schema-store-db 	lsp-kubernetes-helm-select-buffer-schema
lsp-kubernetes-helm-set-buffer-schema 	lsp-lens-hide
lsp-lens-mode 	lsp-lens-show
lsp-lisp-alive-start-ls 	lsp-load-vscode-workspace
lsp-log-io-mode 	lsp-log-io-next
lsp-log-io-prev 	lsp-managed-mode
lsp-mode 	lsp-modeline-code-actions-mode (s-l T a)
lsp-modeline-diagnostics-mode (s-l T D) 	lsp-modeline-workspace-status-mode
lsp-mouse-click (<mouse-3>) 	lsp-ocaml-find-alternate-file
lsp-ocaml-infer-interface 	lsp-ocaml-type-enclosing
lsp-ocaml-type-enclosing-copy 	lsp-ocaml-type-enclosing-decrease-verbosity
lsp-ocaml-type-enclosing-go-down 	lsp-ocaml-type-enclosing-go-up
lsp-ocaml-type-enclosing-increase-verbosity 	lsp-org
lsp-organize-imports (s-l r o) 	lsp-phpactor-install-extension
lsp-pyright-organize-imports 	lsp-rename (s-l r r)
lsp-restart-workspace (lsp-workspace-restart) 	lsp-roslyn-open-solution-file
lsp-rust-analyzer-debug 	lsp-rust-analyzer-expand-macro
lsp-rust-analyzer-join-lines 	lsp-rust-analyzer-move-item-down
lsp-rust-analyzer-move-item-up 	lsp-rust-analyzer-open-cargo-toml
lsp-rust-analyzer-open-external-docs 	lsp-rust-analyzer-related-tests
lsp-rust-analyzer-reload-workspace 	lsp-rust-analyzer-rerun
lsp-rust-analyzer-run 	lsp-rust-analyzer-status
lsp-rust-analyzer-status-mode 	lsp-rust-analyzer-syntax-tree
lsp-rust-analyzer-syntax-tree-mode 	lsp-rust-analyzer-view-hir
lsp-rust-analyzer-view-item-tree 	lsp-rust-find-parent-module
lsp-rust-switch-server 	lsp-save-vscode-workspace
lsp-select-installation-buffer 	lsp-semantic-tokens-mode
lsp-semantic-tokens-suggest-overrides 	lsp-shutdown-workspace (lsp-workspace-shutdown)
lsp-signature-activate (C-S-SPC) 	lsp-signature-mode
lsp-signature-next 	lsp-signature-previous
lsp-signature-stop 	lsp-signature-toggle-full-docs
lsp-sql-execute-paragraph 	lsp-sql-execute-query
lsp-sql-show-connections 	lsp-sql-show-databases
lsp-sql-show-schemas 	lsp-sql-show-tables
lsp-sql-switch-connection 	lsp-sql-switch-database
lsp-start-plain 	lsp-switch-to-io-log-buffer (lsp-workspace-show-log)
lsp-terraform-ls--modules-refresh 	lsp-terraform-ls-init
lsp-terraform-ls-module-calls 	lsp-terraform-ls-providers
lsp-terraform-ls-validate 	lsp-terraform-ls-version
lsp-terraform-modules-mode 	lsp-toggle-on-type-formatting (s-l T f)
lsp-toggle-signature-auto-activate (s-l T s) 	lsp-toggle-symbol-highlight (s-l T h)
lsp-toggle-trace-io (s-l T L) 	lsp-ui-doc--handle-mouse-movement
lsp-ui-doc--open-markdown-link 	lsp-ui-doc--tooltip-mouse-motion
lsp-ui-doc-focus-frame 	lsp-ui-doc-frame-mode
lsp-ui-doc-glance (s-l h g) 	lsp-ui-doc-hide
lsp-ui-doc-mode (s-l T d) 	lsp-ui-doc-show
lsp-ui-doc-toggle 	lsp-ui-doc-unfocus-frame
lsp-ui-find-next-reference 	lsp-ui-find-prev-reference
lsp-ui-find-workspace-symbol 	lsp-ui-flycheck-list
lsp-ui-flycheck-list--quit 	lsp-ui-flycheck-list--view
lsp-ui-flycheck-list--visit 	lsp-ui-flycheck-list-mode
lsp-ui-imenu 	lsp-ui-imenu--kill
lsp-ui-imenu--next-kind 	lsp-ui-imenu--prev-kind
lsp-ui-imenu--refresh 	lsp-ui-imenu--view
lsp-ui-imenu--visit 	lsp-ui-imenu-buffer-mode
lsp-ui-imenu-mode 	lsp-ui-mode
lsp-ui-peek--abort 	lsp-ui-peek--goto-xref
lsp-ui-peek--goto-xref-other-window 	lsp-ui-peek--select-next
lsp-ui-peek--select-next-file 	lsp-ui-peek--select-prev
lsp-ui-peek--select-prev-file 	lsp-ui-peek--toggle-file
lsp-ui-peek-enable 	lsp-ui-peek-find-definitions (s-l G g)
lsp-ui-peek-find-implementation (s-l G i) 	lsp-ui-peek-find-references (s-l G r)
lsp-ui-peek-find-workspace-symbol (s-l G s) 	lsp-ui-peek-mode
lsp-ui-sideline-apply-code-actions 	lsp-ui-sideline-mode (s-l T S)
lsp-ui-sideline-toggle-symbols-info 	lsp-uninstall-server
lsp-uninstall-servers 	lsp-update-server
lsp-update-servers 	lsp-v-analyzer-init
lsp-version 	lsp-virtual-buffer-disconnect
lsp-wgsl-full-source 	lsp-wgsl-syntax-tree
lsp-workspace-blocklist-remove (s-l F b) 	lsp-workspace-folders-add (s-l F a)
lsp-workspace-folders-open 	lsp-workspace-folders-remove (s-l F r)
lsp-workspace-folders-switch (lsp-workspace-folders-open) 	lsp-workspace-remove-all-folders
lsp-workspace-restart (s-l w r) 	lsp-workspace-show-log
lsp-workspace-shutdown (s-l w q) 	lsp-yaml-download-schema-store-db
lsp-yaml-select-buffer-schema 	lsp-yaml-set-buffer-schema
